NO ./north.xpm SO ./south.xpm
WE ./west.xpm
EA ./east.xpm


F 1,255, 255
C 225,30,214

111111111111111111
100000000000000001
100000000000000001
100000000000000001
100000000000000001
100000000000000001
10000000W000000001
100000000000000001
100000000000000001
100000000000000001
100000000000000001
100000000000000001
111111111111111111
