SO ./south.xpm
NO ./north.xpm
EA ./east.xpm
WE ./west.xpm

C 69, 179, 214
F 105, 105, 105

        1111111111111111111111111
        1000000011110000000000001
        1001000000000000000000001
        1001000000000000000000001
111111111001000001110000000000001
100000000011000001000001111111111
11100000000000001100000010001
10000111111111000100100010001
10000000010000000100100010001
10000000010000000100100010001
10000000010000000100100010001
1000000000000W000000000000001
10000000000000000000000000001
11111111111111111111111111111

