F 105, 105, 105
NO ./north.xpm
SO ./south.xpm
C 69, 179, 214
C 69, 179, 214

WE ./west.xpm
EA ./east.xpm
11111
101N1
11111
